A format is NEVER part of a data recovery or disk rebuild process and if done in such circumstances will normally lead to loss of all data on the disks being formatted=A format is **NEVER** part of a data recovery or disk rebuild process and if done in such circumstances will normally lead to loss of all data on the disks being formatted
Aborted=中止
Add=添加
Add Pool=添加储存池
All existing data on this device will be OVERWRITTEN when array is Started=阵列启动时，此设备上的所有现有数据将被覆盖
Array Devices=阵列设备
Array of %s devices=%s 设备的阵列
Array Operation=阵列操作
Attribute Name=属性名称
Attributes=属性
Balance Status=余额状态
Balance=余额
Blacklisted=已列入黑名单
Boot Device=启动设备
Boot system in UEFI mode=UEFI模式下的引导系统
btrfs balance status=btrfs余额状态
btrfs check status=btrfs检查状态
btrfs filesystem df=btrfs文件系统df 
BTRFS operation is running=BTRFS操作正在运行
btrfs scrub status=btrfs清理状态
Can not read attributes=无法读取属性
Can not read capabilities=无法读取功能
Can not read identification=无法读取识别码
Canceled=已取消
Cannot contact key-server Please check your=无法联系密钥服务器请检查您的
Capabilities=功能
Check Filesystem Status=检查文件系统状态
Clear Stats=清除统计信息
Clearing in progress=正在清除中
Click to spin down device=点击以降低设备
Click to spin up device=点击以启动设备
Comments=注释
complete=完成
Completed without error=已完成且无错误
Configuration valid=配置有效
Convert to raid0 mode=转换为 raid0 模式
Convert to raid1 mode=转换为 raid1 模式
Convert to raid10 mode=转换为 raid10 模式
Convert to raid5 mode see help=Convert to raid5 mode *see help
Convert to raid6 mode see help=Convert to raid6 mode *see help
Convert to single mode=转换为单一模式
Copying=正在复制
corrected=已更正
Create an empty file system on the disks shown as Unmountable discarding all data currently on the disks and update parity to reflect this=在显示为无法装载的磁盘上创建空文件系统，丢弃当前磁盘上的所有数据，并更新奇偶校验以反映这一点
Creating Flash backup=创建Flash备份
creating Flash backup zip file this may take several minutes=creating Flash backup zip file (this may take several minutes)
Creation error=创建错误
Critical disk temperature threshold=临界磁盘温度阈值
Critical disk utilization threshold=临界磁盘利用率阈值
Current operation %s on %s=Current operation %s on **%s**
Current position=当前位置
Custom attributes use comma to separate numbers=Custom attributes (use comma to separate numbers)
Date of purchase=购买日期
Date=日期
Delete Pool=删除储存池
detected=检测到
Device encrypted and unlocked=设备已加密并已解锁
Device encrypted=设备已加密
Device is part of a pool=设备是池的一部分
Device locked unknown error=设备锁定未知错误
Device locked wrong encryption key=Device locked: wrong encryption key
Device to be encrypted=要加密的设备
Disk in parity slot is not biggest=奇偶校验插槽中的磁盘不是最大
Disk Log Information=磁盘日志信息
Do not use reserved names=不要使用保留名称
Do not use user share names=不使用用户共享名
Download SMART report=下载SMART报告
Dual parity valid requires ALL disks in their original slots=*Dual parity* valid requires **ALL** disks in their original slots
Elapsed time=经过的时间
encrypted=加密
Encryption input=加密输入
Encryption status=加密状态
Enter new key=输入新密钥
Errors occurred - Check SMART report=发生错误-检查SMART报告
Estimated finish=估计完成
Estimated speed=估计速度
Failed=失败
Feature=功能
File system status=文件系统状态
File system type=文件系统类型
Finding %s error=Finding: **%s** error
Finding %s errors=Finding: **%s** errors
Flag=标志
Flash backup=Flash备份
Flash Device Settings=闪存设备设置
Format Unmountable disks=格式化无法安装的磁盘
Formatting=格式
formatting=格式
Free=免费
FS=FS 
Global Configuration=全局配置
Hide=隐藏
Identification=识别
Identity=相同
if checked, Start array but do not mount disks=如果选中，则启动阵列但不装载磁盘
If this is a new array, move the largest disk into the parity slot=如果这是一个新阵列，请将最大的磁盘移到奇偶校验插槽
If you are adding a new disk or replacing a disabled disk, try Parity-Swap=如果要添加新磁盘或替换禁用的磁盘，请尝试奇偶校验交换
If you want to preserve the data on the new disks, reset the array configuration and rebuild parity instead=如果要保留新磁盘上的数据，请重置阵列配置并重建奇偶校验
Information=信息
Install a replacement disk as soon as possible=尽快安装替换磁盘
Insufficient free disk space available=可用磁盘空间不足
Interrupted=中断
Invalid configuration=无效的配置
Invalid expansion=无效的扩展
Invalid pool name=无效的池名称
is only available when array is Started in Maintenance mode=is only available when array is Started in **Maintenance mode**
is only available when array is Started=仅在数组启动时可用
Keyfile=密钥文件
Last check completed on %s=上次检查完成时间为 **%s**
Last check incomplete on %s=上次检查未完成日期为 **%s**
Last checked on %s=上次选中的时间 **%s**
Last SMART test result=上次SMART测试结果
Maintenance mode=维护模式
Maintenance Mode=维护模式
Maintenance=维护
Manufacturing date=制造日期
Menu View=菜单视图
Minimum free space=最小可用空间
Missing Cache disk=缺少缓存磁盘
Missing disk=缺少磁盘
Missing key=缺少钥匙
Missing=缺少
Mounted=已安装
Mover is running=移动器正在运行
network settings=网络设置
New data disks detected=检测到新数据磁盘
No array data disks have been assigned=未分配任何阵列数据磁盘
No data disks=没有数据磁盘
No parity check history present=没有奇偶校验历史记录
No self-tests logged on this disk=此磁盘上没有记录任何自检
Not installed=未安装
Note do not use pool names which are also used as user share names=Note: do not use pool names which are also used as user share names
OK=OK 
Once clear completes, the array may be Started, expanding the array to include the new disks=清除完成后，可以启动阵列，将阵列扩展为包括新磁盘
Once copy completes, the array may be Started, to initiate Data-Rebuild of the disabled disk=复制完成后，可以启动阵列，以启动禁用磁盘的数据重建。
operation=操作
Options see Help=Options (see Help)
Otherwise use the keyfile method for UTF8 input=Otherwise use the **keyfile** method for UTF8 input
Parity disks content will be overwritten=*Parity* disk(s) content will be overwritten
Parity is already valid=奇偶校验已经有效
Parity operation is running=奇偶校验操作正在运行
Parity valid requires ALL disks to have their original content=*Parity valid* requires **ALL** disks to have their original content
Parity-Check in progress=正在进行奇偶校验
ParityRead-Check History=Parity/Read-Check History
Parity-SyncData-Rebuild in progress=Parity-Sync/Data-Rebuild in progress
Partition format=分区格式
Partition size=分区大小
Passed=通过
Passphrase=密码
Perform full balance=执行全部余额
Permit UEFI boot mode=允许UEFI引导模式
Please check your system settings to support UEFI boot mode=请检查您的系统设置以支持UEFI引导模式
Pool Devices=池设备
Pool name already exists=池名称已存在
Pool of %s devices=％s 设备池
Preclear in progress=预审正在进行中
Printable Characters Only=仅可打印字符
Proceed to start=继续开始
Raw Value=原始值
Raw View=原始视图
Read-Check in progress=正在进行读取检查
Reboot in safe mode=以安全模式重启
registration key=注册密钥
Registration Key Manager=注册密钥管理器
reiserfsck status=reiserfsck status 
Rename Pool=重命名池
Rename=重命名
Repair corrupted blocks=修复损坏的块
Replacement disk installed=已安装替换磁盘
Replacement disk is too small=替换磁盘太小
Retype passphrase=重新输入密码
Schedule=时间表
Scrub Status=擦洗状态
Scrub=擦洗
See Cache Settings=请参阅缓存设置
self-test in progress=正在进行自检
Self-Test=自检
Server boot mode=服务器启动模式
Set default boot menu=设置默认启动菜单
show passphrase=显示密码
Show=显示
Slots=插槽
SMART attribute notifications=SMART属性通知
SMART error log=SMART错误日志
SMART extended self-test=SMART扩展自检
SMART health-check failed=SMART健康检查失败
SMART notification value=SMART通知值
SMART self-test history=SMART自检历史记录
SMART Settings=SMART设置
SMART short self-test=SMART简短自检
SMART status=SMART状态
Speed=速度
Spin down delay=旋转延迟
Spin Down=降速
Spin Up=旋转
Spinup groups=衍生组
Started, array protected=已开始，数组受保护
Started, array unprotected=已启动，阵列未受保护
Started, formatting=已开始，格式为
Starting=开始
Stopping=正在停止
Sync errors=同步错误
Sync=同步
Syslinux Configuration=Syslinux配置
Syslinux configuration=Syslinux配置
Temp=温度
The array will be immediately available, but unprotected since parity has not been assigned=The array will be immediately available, but **unprotected** since *parity* has not been assigned
The array will be immediately available, but unprotected until Parity-Sync completes=The array will be immediately available, but **unprotected** until Parity-Sync completes
The replacement disk must be as big or bigger than the original=替换磁盘必须大于或等于原始磁盘
This is typically done when a new disk is added to the array to get it ready for files to be written to it=当将新磁盘添加到阵列中以使其准备好将文件写入其中时，就可以完成此操作
This unRAID Server OS release has been withdrawn and may no longer be used. Please %s update your server=此unRAID Server OS版本已撤消，可能不再使用。请 ％s 更新您的服务器
This will reboot the system=这将重启系统
This will shutdown the system=这将关闭系统
This will stop the array=这将停止数组
This will stop the running operation=这将停止运行操作
Threshold=阈值
Title=标题
Toggle readswrites display=Toggle reads/writes display
Too many attached devices Please consider upgrading your=连接的设备过多，请考虑升级您的
Too many wrong andor missing disks=Too many wrong and/or missing disks
Total size=总尺寸
Unassign ALL devices to delete this pool=Unassign **ALL** devices to delete this pool
unavailable no parity-check entries logged=unavailable (no parity-check entries logged)
Unavailable - disk must be spun up=不可用-磁盘必须旋转
Unavailable=不可用
Unclean shutdown detected=检测到不正常关机
Unmountable disk present=存在无法安装的磁盘
Unmountable disks present=存在无法安装的磁盘
Unmountable Encrypted volume present=Unmountable: Encrypted volume present
Unmountable Missing encryption key=Unmountable: Missing encryption key
Unmountable No file system=Unmountable: No file system
Unmountable No pool uuid=Unmountable: No pool uuid
Unmountable not btrfs pool=Unmountable: not btrfs pool
Unmountable Volume not encrypted=Unmountable: Volume not encrypted
Unmounted=未安装
Upgrading diskswapping parity=Upgrading disk/swapping parity
Use ASCII characters from space to tilde=Use **ASCII** characters from space to tilde
Use Default=使用默认
Use default=使用default 
Use only lowercase with no special characters or leadingtrailing digits=Use only lowercase with no special characters or leading/trailing digits
use printable characters only=仅使用可打印字符
Used=已使用
Value=值
WARNING canceling may leave the array unprotected=WARNING: canceling may leave the array unprotected
Warning disk temperature threshold=警告盘温度阈值
Warning disk utilization threshold=警告磁盘利用率阈值
WARNING=警告
Warranty period=保修期限
will activate a clean system power down=将激活干净的系统电源
will activate a clean system reset=将激活干净的系统重置
will bring the array on-line and start Clearing new data disks=will bring the array on-line and start **Clearing** new data disks
will bring the array on-line and start Parity-Check=will bring the array on-line and start **Parity-Check**
will bring the array on-line and start Parity-Sync andor Data-Rebuild=will bring the array on-line and start **Parity-Sync** and/or **Data-Rebuild**
will bring the array on-line=将使数组在线
will copy the parity information to the new parity disk=会将奇偶校验信息复制到新的奇偶校验磁盘
will create a file system in all Unmountable disks=将在所有不可安装的磁盘中创建文件系统
will delete the encryption keyfile=将删除加密密钥文件
will disable the missing disk and then bring the array on-line Install a replacement disk as soon as possible=将禁用丢失的磁盘，然后使阵列联机。尽快安装替换磁盘将禁用丢失的磁盘，然后使阵列联机。尽快安装替换磁盘
will expand the file system of the data disk if possible then bring the array on-line and start Data-Rebuild=will expand the file system of the data disk; if possible then bring the array on-line and start Data-Rebuild
will immediately clear all disk statistics=将立即清除所有磁盘统计信息
will immediately invoke the Mover=将立即调用Mover 
will immediately spin down all disks=将立即降低所有磁盘的速度
will immediately spin up all disks=将立即启动所有磁盘
will pause the Clearing=将暂停清算
will pause the Parity-Check=将暂停奇偶校验
will pause the Parity-SyncData-Rebuild=will pause the Parity-Sync/Data-Rebuild
will pause the Read-Check=将暂停Read-Check 
will record all disk information and bring the array on-line=将记录所有磁盘信息并使阵列联机
will record all disk information, bring the array on-line, and start Parity-Sync=将记录所有磁盘信息，使阵列联机并启动Parity-Sync 
will record the new disks information and bring the expanded array on-line=将记录新磁盘信息并在线扩展阵列
will remove the missing cache disk and then bring the array on-line=将删除丢失的缓存磁盘，然后使阵列联机
will resume the paused Clearing=将恢复暂停的Clearing 
will resume the paused Parity-Check=将恢复暂停的奇偶校验
will resume the paused Parity-SyncData-Rebuild=will resume the paused Parity-Sync/Data-Rebuild
will resume the paused Read-Check=将恢复暂停的Read-Check 
will start Clearing new data disks=will start **Clearing** new data disks
will start Parity-Check=will start **Parity-Check**
will start Parity-Sync andor Data-Rebuild=will start **Parity-Sync** and/or **Data-Rebuild**
will start Read-Check of all array disks=will start **Read-Check** of all array disks
will start Read-Check of all data disks=will start **Read-Check** of all data disks
will stop Clearing=将停止清除
will stop Parity-SyncData-Rebuild=will stop Parity-Sync/Data-Rebuild
will stop the Parity-Check=将停止奇偶校验
will stop the Read-Check=将停止Read-Check 
will take the array off-line=将使阵列离线
Worst=最差
Write corrections to parity=将更正写入奇偶校验
Writes=写入
Wrong key=密码错误
xfs_repair status=xfs_repair状态
You may not add new disks and also remove existing disks=您不能添加新磁盘，也不能删除现有磁盘
your server=您的服务器
