20 EHCI=2.0 (EHCI)
30 nec XHCI=3.0 (nec XHCI)
30 qemu XHCI=3.0 (qemu XHCI)
Allocation=分配
and if using graphics device passthrough it too needs UEFI=如果使用图形设备直通，则也需要UEFI 
Are you sure=你确定
Array must be started to view Virtual Machines=Array must be **started** to view Virtual Machines
Autostart=自动启动
Back=返回
Bus=Bus
Capacity=容量
Change Icon=更改图标
Cleanup=清理
Click and Select cdrom image to install operating system=单击并选择cdrom映像以安装操作系统
Config Folder=配置文件夹
Copy Paste Domain XML Configuration Here=Copy &amp; Paste Domain XML Configuration Here
CPU Mode=CPU模式
CPUs=CPU 
Create=创建
Creating=正在创建
define the amount memory=定义内存数量
define the maximum amount of memory=定义最大内存量
define type of cpu presented to this vm=定义提供给此vm的cpu的类型
description of virtual machine=虚拟机的描述
Disk devices=磁盘设备
Download Folder=下载文件夹
Download, Click and Select virtio drivers image=下载，单击并选择virtio驱动程序image 
Downloading=正在下载
eg=e.g.例如 eg
Emulated=仿真
Extracting=正在提取
Folder to save the LibreELEC image to=将LibreELEC图像保存到的文件夹
Folder to save the OpenELEC image to=将OpenELEC图像保存到的文件夹
Form View=表单视图
free=免费
Graphics Card=显卡
Graphics ROM BIOS=图形ROM BIOS 
Graphics=图形
Host Passthrough=主机通过
Hyperv tweaks for Windows=Windows的Hyperv调整
Hyper-V=超V 
i440fx will work for most=i440fx适用于大多数
Icon=图标
Initial=最小
Invalid VM to edit=无效的虚拟机进行编辑
ISO storage path doesnt exist=ISO storage path doesn't exis
ISO storage path was empty=ISO存储路径为空
keyboard for VNC=VNC的键盘
LibreELEC Version=LibreELEC版本
LibreELEC=LibreELEC 
Libvirt Service failed to start=Libvirt服务无法启动
Logical CPUs=符合CPU 
Machine=机器
Manual=手动
Max=最大
MD5 verification failed, your download is incomplete or corrupted=MD5验证失败，您的下载未完成或损坏
mount tag inside vm=在vm 内挂载标签
My Workstation=我的工作站
name of mount tag inside vm=vm 内的挂载标签名称
Name of virtual machine=虚拟机名称
Network Bridge=网桥
Network MAC=网络MAC 
No Virtual Machines installed=未安装虚拟机
None available=无可用
Not enough free space, need at least=可用空间不足，至少需要
Not running=没有运行
OpenELEC Version=OpenELEC版本
OpenELEC=OpenELEC 
OS Install CDRom Bus=操作系统安装CDRom总线
OS Install ISO=安装系统ISO文件
Other PCI Devices=其他PCI设备
OVMF requires a UEFI-compatable OS=OVMF需要与UEFI兼容的OS 
OVMF=OVMF 
password for VNC=VNC的密码
path of Unraid share=Unraid分享的路径
path on Unraid share to save LibreELEC settings=Unraid共享上的路径以保存LibreELEC设置
path on Unraid share to save OpenELEC settings=Unraid共享上的路径以保存OpenELEC设置
Path to ROM BIOS file=ROM BIOS文件的路径
Please choose a folder the LibreELEC image will download to=请选择一个LibreELEC图片将下载到的文件夹
Please choose a folder the OpenELEC image will download to=请选择OpenELEC映像将下载到的文件夹
Primary=基本
Q35 for a newer machine model with PCIE=Q35，带有PCIE的较新机器型号
QEMU64=QEMU64 
random mac, you can supply your own=随机Mac，您可以提供自己的
re-generate random mac address=重新生成随机的mac地址
Remove LibreELEC image=删除LibreELEC图片
Remove OpenELEC image=删除OpenELEC图片
Remove this LibreELEC file=删除此LibreELEC文件
Remove this OpenELEC file=删除此OpenELEC文件
SeaBIOS will work for most=SeaBIOS将适用于大多数情况
SeaBIOS=SeaBIOS 
Select the BIOS=选择BIOS 
Select the LibreELEC version to use=选择要使用的LibreELEC版本
Select the machine model=选择机器型号
Select the OpenELEC version to use=选择要使用的OpenELEC版本
Select the USB Controller to emulate=选择要仿真的USB控制器
Separate sub-folder and image will be created based on Name=将基于Name 创建单独的子文件夹和图像
shares=份数
Some OSes wont support USB3=Some OSes won't support USB3
Sound Card=声卡
Start All=全部开始
Start VM after creation=创建后启动VM 
Stop All=全部停止
Toggle VM auostart=切换虚拟机auostart 
type of storage image=存储映像类型
Unknown action=未知动作
Unknown version=未知版本
Unraid Mount tag=突袭挂载标签
Unraid Share=UNRAID分享
Updating=更新
USB Controller=USB控制器
USB Devices=USB设备
vDisk Bus=虚拟磁盘总线
vDisk Location=虚拟磁盘位置
vDisk Size=虚拟磁盘大小
vDisk Type=虚拟磁盘类型
vDisks=虚拟磁盘
video for VNC=VNC视频
VirtIO Drivers CDRom Bus=VirtIO驱动程序CDRom总线
VirtIO Drivers ISO=VirtIO驱动程序ISO 
Virtual Machines=虚拟机
VM creation error=虚拟机创建错误
VM image deletion error=VM映像删除错误
VNC Keyboard=VNC键盘
VNC Password=VNC密码
VNC Video Driver=VNC视频驱动程序
VNC=VNC 
Wasnt able to stop the process=Wasn't able to stop the process
Windows 7XP=Windows 7/XP
Windows 82012, newer Linux distros=Windows 8/2012, newer Linux distros
XML View=XML视图
